25 25
0 0 0 0 1 2 2 0 0 0 2 2 2 1 2 0 1 2 0 0 2 0 0 0 3
0 1 1 1 0 0 1 1 1 1 1 1 1 1 0 2 1 1 1 2 0 1 1 1 0
1 2 1 2 1 2 2 1 2 2 1 2 1 2 1 0 2 1 2 1 2 2 1 2 0
1 1 2 1 0 0 1 1 1 0 0 1 1 1 2 0 1 1 1 2 2 1 1 1 0
1 2 1 2 1 0 2 1 2 2 1 2 1 2 1 0 2 1 2 0 2 2 1 2 1
9 9 9 9 9 10 1 2 0 2 1 0 1 1 1 2 0 0 2 2 1 0 0 0 1
5 5 5 5 5 8 2 0 0 0 2 2 2 1 2 0 1 2 0 3 2 0 0 0 0
5 5 5 5 5 8 1 1 1 1 1 1 1 1 0 2 1 1 1 0 0 1 1 1 0
5 5 5 5 5 8 2 1 2 2 1 2 1 2 1 0 2 1 2 1 2 2 1 2 0
5 5 5 5 5 8 1 1 1 0 0 1 1 1 2 1 1 1 1 1 2 1 1 1 0
5 5 5 5 5 8 1 1 2 2 1 2 1 2 1 0 2 1 2 2 2 2 1 2 0
5 5 5 5 5 8 2 2 0 2 1 0 1 1 1 2 0 0 2 2 1 0 0 0 1
5 5 5 5 5 8 0 1 0 0 2 2 2 1 2 0 4 2 0 0 2 0 0 0 2
5 5 5 5 5 8 0 0 1 1 1 1 1 1 0 4 3 0 1 0 0 1 1 1 2
5 5 5 5 5 8 2 1 2 2 1 2 1 2 1 0 2 0 0 0 2 2 1 2 0
5 5 5 17 6 12 2 1 1 0 0 1 1 1 2 0 1 1 1 1 2 1 1 1 2
5 5 5 8 4 2 2 1 2 2 1 2 1 2 1 0 2 1 2 0 2 2 1 2 0
5 5 5 8 2 4 2 0 2 1 0 1 1 1 0 0 0 2 2 1 0 0 0 0 2
5 5 5 8 1 2 2 0 0 1 2 2 2 0 0 0 1 2 0 3 2 0 0 0 1
5 5 17 12 0 0 1 1 1 3 1 1 0 0 0 2 1 1 1 4 0 1 1 1 0
5 5 8 2 1 2 2 1 2 2 1 2 1 2 1 0 2 1 2 0 2 2 1 2 0
5 17 12 1 0 0 1 1 1 0 0 1 1 1 2 0 1 1 1 1 2 1 1 1 0
5 8 1 2 1 0 2 1 2 2 1 2 1 2 1 0 2 1 2 1 2 2 1 2 0
17 1 2 1 2 2 1 2 0 2 1 0 1 1 1 2 0 0 2 2 1 0 0 0 0
1 2 1 2 1 2 2 1 2 2 1 2 1 2 1 0 2 1 2 0 2 2 1 2 0