25 25
0 0 0 0 1 2 2 0 0 0 2 2 2 1 2 0 1 2 0 0 2 0 0 0 3
0 1 1 1 0 0 1 1 1 1 1 1 1 1 0 2 1 1 1 2 0 1 1 1 0
1 2 1 2 1 2 2 1 2 2 1 2 1 2 1 0 2 1 2 1 2 2 1 2 0
1 1 2 1 0 0 1 1 1 0 0 1 1 1 2 0 1 1 1 2 2 1 1 1 0
9 2 1 2 1 0 2 1 2 2 1 2 1 2 1 0 2 1 2 0 2 2 1 2 1
5 9 2 1 2 2 1 2 0 2 1 0 1 1 1 2 0 0 2 2 1 0 0 0 1
5 5 9 9 1 2 2 0 0 0 2 2 2 1 2 0 1 2 0 3 2 0 0 0 0
5 5 5 5 9 0 1 1 1 1 1 1 1 1 0 2 1 1 1 0 0 1 1 1 0
5 5 5 5 5 9 2 1 2 2 1 2 1 2 1 0 2 1 2 1 2 2 1 2 0
5 5 5 5 5 5 1 1 1 0 0 1 1 1 2 1 1 1 1 1 2 1 1 1 0
5 5 5 5 5 5 2 1 2 2 1 2 1 2 1 0 2 1 2 2 2 2 1 2 0
5 5 5 5 5 5 9 8 0 2 1 0 1 1 1 2 0 0 2 2 1 0 0 0 1
5 5 5 5 5 5 5 8 0 0 2 2 2 1 2 0 1 2 0 0 2 0 0 0 2
5 5 5 5 5 5 6 8 1 1 1 1 1 1 0 2 1 0 1 0 0 1 1 1 2
5 5 5 5 5 5 2 1 2 2 1 2 1 2 1 0 2 0 0 0 2 2 1 2 0
5 5 5 5 5 6 1 1 1 0 0 1 1 1 2 0 1 1 1 1 2 1 1 1 2
5 5 5 5 6 0 2 1 2 2 1 2 1 2 1 0 2 1 2 0 2 2 1 2 0
5 5 5 6 2 1 2 0 2 1 0 1 1 1 2 0 0 2 2 1 0 0 0 0 2
5 5 6 0 1 2 2 0 0 1 2 2 2 1 2 0 1 2 0 3 2 0 0 0 1
5 5 1 1 0 0 1 1 1 3 1 1 1 1 0 2 1 1 1 0 0 1 1 1 0
5 6 1 2 1 2 2 1 2 2 1 2 1 2 1 0 2 1 2 0 2 2 1 2 0
6 1 2 1 0 0 1 1 1 0 0 1 1 1 2 0 1 1 1 1 2 1 1 1 0
2 2 1 2 1 0 2 1 2 2 1 2 1 2 1 0 2 1 2 1 2 2 1 2 0
0 1 2 1 2 2 1 2 0 2 1 0 1 1 1 2 0 0 2 2 1 0 0 0 0
1 2 1 2 1 2 2 1 2 2 1 2 1 2 1 0 2 1 2 0 2 2 1 2 0