25 25
22 22 22 22 22 22 22 22 22 22 22 22 22 22 22 22 22 22 22 22 22 22 22 22 22
23 23 23 23 23 23 23 23 23 23 23 23 23 23 23 23 23 23 23 23 23 23 23 23 24
19 2 1 2 1 2 2 1 2 2 1 2 1 2 1 0 2 1 2 1 2 2 1 2 20
19 1 2 1 0 0 1 1 1 0 0 1 1 1 2 0 1 1 1 2 2 1 1 1 20
19 9 9 9 10 0 2 1 2 2 1 2 1 2 1 0 2 1 2 0 2 2 1 2 20
19 5 5 5 15 10 1 2 0 2 1 0 1 1 1 2 0 0 2 2 1 0 0 0 20
19 5 5 5 5 8 2 0 0 0 2 2 2 1 2 0 1 2 0 3 2 0 0 0 20
19 5 5 5 5 8 1 1 1 1 1 1 1 1 0 2 1 1 1 0 0 1 1 1 20
19 5 5 5 5 8 2 1 2 2 1 2 1 2 1 0 2 1 2 1 2 2 1 2 20
19 5 5 5 5 8 1 1 1 0 0 1 1 1 2 1 1 1 1 1 2 1 1 1 20
19 5 5 5 5 8 1 1 2 2 1 2 1 2 1 0 2 1 2 2 2 2 1 2 20
19 5 5 5 5 8 2 2 0 2 1 0 1 1 1 2 0 0 2 2 1 0 0 0 20
19 5 5 5 5 8 0 1 0 0 2 2 2 1 2 0 4 2 0 0 2 0 0 0 20
19 5 5 5 5 8 0 0 1 1 1 1 1 1 0 4 3 0 1 0 0 1 1 1 20
19 5 5 5 5 8 2 1 2 2 1 2 1 2 1 0 2 0 0 0 2 2 1 2 20
19 5 5 17 6 12 2 1 1 0 0 1 1 1 2 0 1 1 1 1 2 1 1 1 20
19 5 5 8 4 2 2 1 2 2 1 2 1 2 1 0 2 1 2 0 2 2 1 2 20
19 5 5 8 2 4 2 0 2 1 0 1 1 1 0 0 0 2 2 1 0 0 0 0 20
19 5 5 8 1 2 2 0 0 1 2 2 2 0 0 0 1 2 0 3 2 0 0 0 20
19 5 17 12 0 0 1 1 1 3 1 1 0 0 0 2 1 1 1 4 0 1 1 1 20
19 5 8 2 1 2 2 1 2 2 1 2 1 2 1 0 2 1 2 0 2 2 1 2 20
19 17 12 1 0 0 1 1 1 0 0 1 1 1 2 0 1 1 1 1 2 1 1 1 20
19 8 1 2 1 0 2 1 2 2 1 2 1 2 1 0 2 1 2 1 2 2 1 2 20
19 18 18 18 18 18 18 18 18 18 18 18 18 18 18 18 18 18 18 18 18 18 18 18 21
22 22 22 22 22 22 22 22 22 22 22 22 22 22 22 22 22 22 22 22 22 22 22 22 22